1111111111111111111
1000000100200000001
1000040000000030001
1000000111000000001
1000000111000000001
1111111111111111111