111110000000
104010000000
104011111111
100000000001
103300000001
102000000001
111111111111