1111100000
1440100000
1000111111
1000000001
1000000301
1000000301
1200000001
1111111111